NO ./texture/wall.xpm
SO ./texture/wall.xpm

WE ./texture/wall.xpm
 	 EA ./texture/wall.xpm  		 

F 255,255,0
C 51,255,255



1111111111111111111111111
1100000000000000000000000111
1000000000000000000011111111
111000000000111000000000001


1000000000001 10000000000001
1000000000001100000000000001
1000000W00000000000000000001
1000111000000000000011100001
1000111000000000000111000001
1111111111111111111111111111
