NO ./texture/wall.xpm
EA ./texture/wall.xpm

  
SO ./texture/wall.xpm
  
C 51,255,255
	
WE ./texture/wall.xpm
F               255,255,0 

    

    

   

 
111111111111111
1000010000000001
10000100000000011111111111111111111111111111
11111111111111111111111111111111111111111111
100001000111101100000000000000000000000000E1
11110010110100000000000000000000000000111001
100001001111000000000011111111111111001 1001
10000100000000011100001            1001 1001
100001101100111111000011111111111111001 1001
1000000000000001 100000000000000000000111001
1000000000001101 100000000000000000000000001
1111111101111111 100000000000000000000000001
       111       111111111111111111111111111
       101                           1000001
       101                           1000001
       1011111111111111111111111111111000001
       1000000000000000000000000000000000001
       1111111111111111111111111111111000001
                                     111111 


    


