NO ./texture/wallchelou.xpm
SO ./texture/blue_coal.xpm
EA ./texture/mud_wall.xpm
WE ./texture/synthetic.xpm
F 105,105,105
C 192,192,192




1111111
1000001
10S1001
1011001
1000001
1111111
