NO ./texture/forest.xpm
SO ./texture/forest.xpm
WE ./texture/forest.xpm
EA ./texture/forest.xpm

F 47,79,79
C 119,136,153

111111111111111111111111
100000000000000000000001
100000000000000000000001
1000000W0000000111000011
111110000000000000000001
111111000000111000000001
111111111111111111111111
