NO ./texture/wall.xpm
SO ./texture/floor.xpm
WE ./texture/wall.xpm
EA ./texture/floor.txt
F 220,100,0
C 225,30,0



1111111111111111111111111
1000000000110000000000001
1011000001110000000000001
1001000000000000000000001
1111111110110000011100001
1000000000110110001110111
11110111111111 111000001
11110111111111 11101011
11111111111111 111111
