	



NO ./texture/wall.xpm
SO ./texture/floor.xpm
WE ./texture/wall.xpm
EA ./texture/floor.xpm
F 220,251,25	
C 225,30,0

11111111111111111111111111111
1000000000111111111111111111
100000000000000000000W00001
111111111111111111111111111
