NO ./texture/blue_coal.xpm
SO ./texture/mud_wall.xpm

EA ./texture/pavement.xpm

WE ./texture/psyche_wall.xpm
F 220,100,0
C 255,255,0

111111
100E1
111111
 