NO ./texture/floor.xpm
SO ./texture/wall.xpm   
EA ./texture/floor.xpm
WE ./texture/wall.xpm    
F 220,100,0
C 210,30,0




111111111111
1000N0000001
110001110001
100000000001
111111111111

