NO ./texture/musee_1.xpm
SO ./texture/musee_2.xpm
EA ./texture/musee_3.xpm
WE ./texture/musee_4.xpm
F 105,105,105
C 192,192,192




111111111111
1000W0000001
110001110001
100000000001
100011111111  
100001111111
100000000001
100000000001
100000111111111
100000000000001
111111111100001
100000000000001
111111111111111
111111111111
11111111111
