NO ./texture/floor.xpm
SO ./texture/wall.xpm 
   
   EA ./texture/floor.xpm 
 
  
WE ./texture/wall.xpm
    
F 220,100,0
   C          210,30,0




11111 1
1001111
10S0001
1111111
