NO ./texture/floor.xpm
SO ./texture/wall.xpm 
   
   EA ./texture/floor.xpm 
 
  
WE ./texture/wall.xpm
    
F 220,100,0
   C          210,30,0




11111 111111
1W0111000001
100000000001
100000000001
111111111111
