NO ./texture/floor.xpm  
SO ./texture/wall.xpm 
   
   EA ./texture/floor.xpm 
 
  
WE ./texture/wall.xpm
    
F 220,100,0
   C          210,30,0




        1111111111111111111111111
        1000000000110000000000001
        101100000111000000000000
        1001000000000E00000000001  1111
111111111011000001110000000000001  1001
100000000011000001110111111111111  1111
11110111111111011100000010001       
111101111111110111010100100011
110000001101010111000000000001
100000000000000011000000000011
10000000000000001101010000001
1100000111010101111101111000011
11110111 1110101 111010001111
11111111 1111111 111111111111
