NO ./texture/floor.xpm  
SO ./texture/wall.xpm 
   
   EA ./texture/floor.xpm 
 
  
WE ./texture/wall.xpm
    
F 220,100,0
   C          210,30,0




        1111111111111111111111111        1111111111111111111111111
        1000000000110000000000001
        1011000001110000000000001
        1001000000000000000000001  1111
111111111011000001110000000000001  1001
100000000011000001110111111111111  1111
11110111111111011100000010001
11110111111111011101010010001
11000000110101011100000000001
10000000000000001100000000001
10000000000000001101010000001 
1100000111010101111101111000011
11110111 1110101 111101000111
11111111 1111111 111111111111        1111111111111111111111111
        1000000000110000000000001
        1011000001110000000000001
        1001000000000000000000001  1111
111111111011000001110000000000001  1001
100000000011000001110111111111111  1111
11110111111111011100000010001
11110111111111011101010010001
11000000110101011100000000001
10000000000000001100000000001
10000000000000001101010000001 
1100000111010101111101111000011
11110111 1110101 111101000111
11111111 1111111 111111111111
        1000000000110000000000001
        1011000001110000000000001
        1001000000000000000000001  1111
111111111011000001110000000000001  1001
100000000011000001110111111111111  1111
11110111111111011100000010001
11110111111111011101010010001
11000000110101011100000000001
10000000000000001100000000001
10000000000000001101010000001 
1100000111010101111101111000011
11110111 1110101 111101000111
11111111 1111111 111111111111
