
NO ./texture/wall_1.xpm
SO ./texture/wall_2.xpm

WE ./texture/wall_3.xpm
EA ./texture/wall_4.xpm

F 0,0,1
C 0,51,117

111111111111111
1000000000000001
1000000000000001
1000000000010001
1000000000000001
1000000000000001
1000000000000001
1000000111000101
100N000000000001
1000000000000001
1111101111111111
    111
