1111111111
1000N000001
1111111111
