NO ./texture/musee_1.xpm
SO ./texture/musee_2.xpm

WE ./texture/musee_3.xpm
 	 EA ./texture/musee_4.xpm  		 

F 51,0,0
C 72,61,139



1111111111111111111111111
1100000000000000000000000111
1000000000000000000011111111
111000000000111000000000001
1000000000001 10000011000001
1000000000001100000000000001
1000000W00000000000000000001
1000111000000000000011100001
1000111000000000000111000001
1111111111111111111111111111
