
NO ./texture/wall.xpm
SO ./texture/wall.xpm

WE ./texture/wall.xpm
EA ./texture/wall.xpm

F 255,255,0
C 51,255,255

111111111111111
1000010000000001
1000S10000000001
1000010001111011
1111011011010001
1000010011110001
1000010000000001
1000011011001111
1000000000000001
1000000000001101
1111111111111111
