
NO ./texture/floor.xpm
SO ./texture/wall.xpm

WE ./texture/wall.xpm
EA ./texture/wall.xpm

F 255,255,0

C 255,255,0
1111111111111111
1000010000000001
1000010000000001
1000010001111011
1111011011010001
10S0010011110001
1000010000000001
1000011011001111
1000000000000001
1000000000001101
1111111111111111
