
WE
EA
NO
SO
F
C

11
11
11111
000
NN
11
SSS
EE
WW
111111
1
1
