NO ./texture/wall.xpm
 SO ./texture/floor.xpm

WE ./texture/wall.xpm
EA ./texture/wall.xpm

C 0,188,212
F 203,178,117  	






111111111111111111111111
10000000000000000000N001
000000000000000000000001
100000000000000000000001
111111111111111111111111
