NO ./texture/wall.xpm
SO ./texture/wall.xpm

WE ./texture/wall.xpm
EA ./texture/wall.xpm

F 255,255,0
C 51,255,255

1111111111111111111111111111111111
 10000000000000000000000000000001
  100000000000000000000000000001
   1000000000000000000000000001
    10000000000000000000000001
     100000000000000000000001
      1000000000000000000001
       10000000000000000001
        100000000000000001
         1000000000000001
          10000000000001
           100000000001
            1000000001
             100000E1
              100001
               1001
                11




