WE ./texture/wall.xpm
NO ./texture/wall.xpm
SO  ./texture/wall.xpm
EA ./texture/wall.xpm 

C 0,188,212
F 203,178,117 

 1111111111111111111111
 1111110001000000100001
 1000000001000000100001
 1111100000000111100001
 0N00011111000000010001
 1000111000000011111001
 1000010001110011000001
 1000000000000000000001
 1111111111111111111111
